0000000000
1111100000
0000100000
0000111100
0000000100
0011111100
0020000000
0000000000