0000000000
1111111000
0000001000
0000001000
0000111000
0000100000
0000200000
0000000000