0000000000
1111111110
0000000010
0111111110
0100000000
0111111100
0000000200
0000000000